111111111111111
1P 1         C1
1 C1 11111 1111
1    1     1C 1
111111 11111  1
1C      1     1
111 11111 11111
1            C1
11111 111111111
1             1
11 1111 11111 1
1  1    1     1
1  1 11 1 11111
1C   1  1     E
111111111111111