111111111111111
1P01000000000C1
10C101111101111
1000000100000C1
111111011111001
1C0000001000001
111011111011111
1000000000000C1
111110111111111
100000000000001
110111101111101
100100001000001
100101101011111
1C0!010000000E1
111111111111111
