1111111111111111
1001000000000C11
10C1011111011111
1000000100000C11
1111110111110011
1C00000010000010
1110111110111111
1000000000000C11
1111101111111111
1P00000000000011
1101111011111011
1001000010000011
1001011010111111
1C00010000000E11
1111111111111111
